9	9	9	9	9	9	9	9	9	9	9	9	9	9	9	9	9	9	9	9	9	9	9	9	9	9	9	9	9	9
9	0	0	0	0	9	9	0	0	3	3	9	9	0	0	0	0	0	0	0	0	0	0	0	0	0	0	0	0	9
9	1	1	5	5	9	9	0	0	3	3	9	9	0	0	0	0	0	0	0	0	0	0	0	0	0	0	0	0	9
9	1	1	5	5	9	9	8	8	3	3	9	9	0	0	0	0	0	0	0	0	0	0	0	0	0	0	0	0	9
9	1	1	5	5	9	9	8	8	3	3	9	9	0	0	0	0	0	0	0	0	0	0	0	0	0	0	0	0	9
9	1	1	5	5	9	9	8	8	3	3	9	9	0	0	0	0	0	0	0	0	0	0	0	0	0	0	0	0	9
9	1	1	5	5	9	9	8	8	3	3	9	9	0	0	0	0	0	0	0	0	0	0	0	0	0	0	0	0	9
9	1	1	5	5	9	9	8	8	3	3	9	9	0	0	0	0	0	0	0	0	0	0	0	0	0	0	0	0	9
9	1	1	5	5	9	9	8	8	3	3	9	9	0	0	0	0	0	0	0	0	0	0	0	0	0	0	0	0	9
9	1	1	5	5	9	9	8	8	3	3	9	9	0	0	0	0	0	0	0	0	0	0	0	0	0	0	0	0	9
9	1	1	5	5	9	9	8	8	6	6	9	9	0	0	0	0	0	0	0	0	0	0	0	0	0	0	0	0	9
9	1	1	5	5	9	9	8	8	3	3	9	9	0	0	0	0	0	0	0	0	0	0	0	0	0	0	0	0	9
9	1	1	5	5	9	9	8	8	3	3	9	9	0	0	0	0	0	0	0	0	0	0	0	0	0	0	0	0	9
9	1	1	5	5	9	9	6	6	3	3	9	9	0	0	0	0	0	0	0	0	0	0	0	0	0	0	0	0	9
9	1	1	5	5	9	9	8	8	3	3	9	9	0	0	0	0	0	0	0	0	0	0	0	0	0	0	0	0	9
9	1	1	5	5	9	9	8	8	3	3	9	9	0	0	0	0	0	0	0	0	0	0	0	0	0	0	0	0	9
9	1	1	5	5	9	9	8	8	3	3	9	9	0	0	0	0	0	0	0	0	0	0	0	0	0	0	0	0	9
9	1	1	5	5	9	9	8	8	3	3	9	9	0	0	0	0	0	0	0	0	0	0	0	0	0	0	0	0	9
9	0	0	0	0	0	0	0	0	0	0	0	0	0	0	0	0	0	0	0	0	0	0	0	0	0	0	0	0	9
9	0	0	0	0	0	0	0	0	0	0	0	0	0	0	0	0	0	0	0	0	0	0	0	0	0	0	0	0	9
9	0	0	0	0	0	0	0	0	0	0	0	0	0	0	0	0	0	0	0	0	0	0	0	0	0	0	0	0	9
9	0	0	0	0	0	0	0	0	0	0	0	0	0	0	0	0	0	0	0	0	0	0	0	0	0	0	0	0	9
9	0	0	0	0	0	0	0	0	0	0	0	0	0	0	0	0	0	0	0	0	0	0	0	0	0	0	0	0	9
9	0	0	0	0	0	0	0	0	0	0	0	0	0	0	0	0	0	0	0	0	0	0	0	0	0	0	0	0	9
9	0	0	0	0	0	0	0	0	0	0	0	0	0	0	0	0	0	0	0	0	0	0	0	0	0	0	0	0	9
9	0	0	0	0	0	0	0	0	0	0	0	0	0	0	0	0	0	0	0	0	0	0	0	0	0	0	0	0	9
9	0	0	0	0	0	0	0	0	0	0	0	0	0	0	0	0	0	0	0	0	0	0	0	0	0	0	0	0	9
9	0	0	0	0	0	0	0	0	0	0	0	0	0	0	0	0	0	0	0	0	0	0	0	0	0	0	0	0	9
9	0	0	0	0	0	0	0	0	0	0	0	0	0	0	0	0	0	0	0	0	0	0	0	0	0	0	0	0	9
9	0	0	0	0	0	0	0	0	0	0	0	0	0	0	0	0	0	0	0	0	0	0	0	0	0	0	0	0	9
9	0	0	0	0	0	0	0	0	0	0	0	0	0	0	0	0	0	0	0	0	0	0	0	0	0	0	0	0	9
9	0	0	0	0	0	0	0	0	0	0	0	0	0	0	0	0	0	0	0	0	0	0	0	0	0	0	0	0	9
9	0	0	0	0	0	0	0	0	0	0	0	0	0	0	0	0	0	0	0	0	0	0	0	0	0	0	0	0	9